offset: -28
===========
a -> y
b -> z
c -> a
d -> b
e -> c
f -> d
g -> e
h -> f
i -> g
j -> h
k -> i
l -> j
m -> k
n -> l
o -> m
p -> n
q -> o
r -> p
s -> q
t -> r
u -> s
v -> t
w -> u
x -> v
y -> w
z -> x

A -> Y
B -> Z
C -> A
D -> B
E -> C
F -> D
G -> E
H -> F
I -> G
J -> H
K -> I
L -> J
M -> K
N -> L
O -> M
P -> N
Q -> O
R -> P
S -> Q
T -> R
U -> S
V -> T
W -> U
X -> V
Y -> W
Z -> X
